1111111111111111111111111111111111111
1111111111111111111111111111111111111
1111111111111111111111111111111111111
1111111111111111111111111111111111111
1111111111111111111111111111111111111
1111110100000000000100000000010011111
1111100000000000000000000000010011111
1111110000010000000000000000000011111
1111111000110000000000000000000011111
1111100000000000000000000000000111111
1111100000000000000000000000000111111
1111100010000000000000000010000011111
1111100000000000000000000000000011111
1111100000000000000000000000000011111
1111100000000000100000000000001011111
1111100000000000000000000000000011111
1111100000000000000000000000000011111
1111100000000000000000000010000011111
1111110000000000000000000000000111111
1111110000000000000000000000000011111
1111110000000000000000000000000111111
1111100010000001000001111100000011111
1111100000000001100001111111000011111
1111100000000000000001111111000011111
1111100000000000000011111111000011111
1111100000000000000011111111000011111
1111100000000000000011011000000011111
1111110000000000010110000000000011111
1111110000010000110000000000000111111
1111110000000001100000000001000111111
1111110011000111000001000000000111111
1111111111111111100000001000001111111
1111111111111111111111111111111111111
1111111111111111111111111111111111111
1111111111111111111111111111111111111
1111111111111111111111111111111111111
1111111111111111111111111111111111111