,,,,,,,,,,,,,,,,,,,,,,,,,,,,,,,,,,,,,
,,,,,,,,,,,,,,,,,,,,,,,,,,,,,,,,,,,,,
,,,,,,,,,,,,,,,,,,,,,,,,,,,,,,,,,,,,,
,,,,,,,,,,,,,,,,,,,,,,,,,,,,,,,,,,,,,
,,,,,,,,,,,,,,,,,,,,,,,,,,,,,,,,,,,,,
,,,,,,.,...........,.........,.H,,,,,
,,,,,........................,.H,,,,,
,,,,,,..X..,....................,,,,,
,,,,,,,...,,.....H..............,,,,,
,,,,,..........................,,,,,,
,,,,,..........................,,,,,,
,,,,,...,.................,.....,,,,,
,,,,,...........................,,,,,
,,,,,................H..........,,,,,
,,,,,...........,.............,.,,,,,
,,,,,...........................,,,,,
,,,,,......H....................,,,,,
,,,,,.....................,.....,,,,,
,,,,,,.........................,,,,,,
,,,,,,..........................,,,,,
,,,,,,.........................,,,,,,
,,,,,...,......,.....,,,,,......,,,,,
,,,,,..........,,....,,,,,,,....,,,,,
,,,,,................,,,,,,,....,,,,,
,,,,,...H...........,,,,,,,,....,,,,,
,,,,,...............,,,,,,,,.H..,,,,,
,,,,,...............,,.,,.......,,,,,
,,,,,,...........,,,,...........,,,,,
,,,,,,.X...,....,,....X........,,,,,,
,,,,,,.........,,..........,...,,,,,,
,,,,,,..,,...,,,..H..,.........,,,,,,
,,,,,,,,,,,,,,,,,.......,.....,,,,,,,
,,,,,,,,,,,,,,,,,,,,,,,,,,,,,,,,,,,,,
,,,,,,,,,,,,,,,,,,,,,,,,,,,,,,,,,,,,,
,,,,,,,,,,,,,,,,,,,,,,,,,,,,,,,,,,,,,
,,,,,,,,,,,,,,,,,,,,,,,,,,,,,,,,,,,,,
,,,,,,,,,,,,,,,,,,,,,,,,,,,,,,,,,,,,,